11111111111111111111111111111111
11111111111111111111111111111111
11CCCCCCCCCCCCCCCCCCCCCCCCCCCC11
11CCCCCCCCCCCCCCCCCCCCCCCCCCCC11
11CCCCCCC1CCCCCCCCC1CCCCCCCCCC11
11CCCCCCC1CCCCCCCCC1CCCCCCCCCC11
11CCCCCCC1CCCCCCCCC1CCCCCCCCCC11
11CCCCCCC1CCCCCCCCC1CCCCCCCCCC11
11CCCCCCC11111111111CCCCCCCCCC11
11CCCCCCCCCCCCCCCCCCCCCCCCCCCC11
11CCCCCCCCCCCCCCCCCCCCCCCCCCCC11
11CCCCCCCCCCCCCCCCCCCCCCCCCCCC11
11C1CCCCCCC1C1CC1CCC1C1CCCCCCC11
11CC1CCCCC1CC1CC11CC1C1CCCCCCC11
11CCC1C1C1CCC1CC1C1C1CCCCCCCCC11
11CCCC1C1CCCC1CC1CC11C1CCCCCCC11
11CCCCCCCCCCCCCCCCCCCCCCCCCCCC11
11CCCCCCCCCCCCCCCCCCCCCCCCCCCC11
11CCCCCCCCCCCCCCCCCCCCCCCCCCCC11
11CCCCCCCCCCCCCCCCCCCCCCCCCCCC11
11CCCCSCCCCCCCCCPCCCCCCCSCCCCC11
11CCCCCCCCCCCCCCCCCCCCCCCCCCCC11
11111111111111111111111111111111
11111111111111111111111111111111
