11111111111111111111111111111111
1..............................1
1..............................1
1..............................1
1..............................1
1..............................1
1..............................1
1........1...........1.........1
1........1...........1.........1
1........1...........1.........1
1..............................1
1..............................1
1....1...................1.....1
1.....1.................1......1
1......11.............11.......1
1........11........P11.........1
1.........11111111111..........1
1..............................1
1..............................1
1..............................1
1..............................1
1..............................1
1..............................1
11111111111111111111111111111111

